
NO   ./maps/testure.xpm
  SO  ./maps/texture.xpm

F 22,33,44
WE   ./maps/testure.xpm


								   




EA   ./maps/testure.xpm
NO ./maps/texture.xpm
C   0,+44,7
11111111
10000001
1 F0000001
10000001
11111111