
NO   ./maps/testure.xpm
  SO  ./maps/texture.xpm

F 22,55,66
WE   ./maps/testure.xpm


								   

EA   ./maps/testure.xpm
NO ./maps/texture.xpm
C   0,+44,7

1111111111
10S0000001
1000000001
1000001001
1000000001
1111111111