
NO   ./maps/testure.xpm
  SO  ./maps/texture.xpm

F 22,55,66
WE   ./maps/testure.xpm


								   

EA   ./maps/testure.xpm
NO ./maps/texture.xpm
C   0,+44,7

 1111 1111
 100111001      111111
 100000000111   1    1
 1001111100001   1111
 1001   10000111111111111111111111
 111    1000000000110000000000001
        1011000001110000000000001
        1001000000000000000000001
111111111011000001110000000000001
100000000011000001110111111111111
11110111111111011100000010001
11110111111111011101010000001111
11000000110101011100000010000001
10000000000000001100000010001111
10000000000000001101010010001
11000001110101011111011110N0111
11110111 11101011  11110100011111111
11111111 1111111   11111111111111110